Bag_of_Pollem	Bulbasaur,Ivysaur,Venusaur,Butterfree,Oddish,Gloom,Vileplume,Parasect,Bellsprout,Weepinbell,Victreebel,Chikorita,Bayleef,Meganium,Bellossom	40
Magikarp_Fin	Magikarp	3
Band_Aid	Mankey,Primeape,Machop,Machoke,Machamp,Hitmonlee,Hitmonchan,Heracross,Tyrogue,Hitmontop	1
Bird_Beak	Pidgeotto,Pidgeot,Fearow,Doduo,Dodrio,Skarmory	30
Bitten_Apple	Rattata,Raticate	5
Bottle_of_Poison	Bulbasaur,Ivysaur,Venusaur,Weedle,Kakuna,Beedrill,Ekans,Arbok,Nidorafane,Nidorina,Nidoqueen,Nidoranma,Nidorno,Nidoking,Zubat,Golbat,Oddish,Gloom,Vileplume,Venonat,Venomoth,Bellsprout,Weepinbell,Victreebel,Tentacool,Tentacruel,Muk,Grimer,Gastly,Haunter,Gengar,Koffing,Weezing,Spinarak,Ariados,Crobat,Qwilfish	1
Bug_Gosme	Caterpie,Metapod,Butterfree,Weedle,Kakuna,Beedrill,Paras,Parasect,Venonat,Venomoth,Scyther,Pinsir,Ledyba,Ledian,Spinarak,Ariados,Yanma,Pineco,Forretress,Scizor,Schukle,Heracross	1
Comb	Clefairy,Clefable,Vulpix,Ninetales,Jigglypuff,Wigglytuff	100
Dark_Gem	Murkrow,Sneasel,Houndour,Houndoom	1
Dragon_Scale	Dratini,Dragonair,Dragonite,Kingdra	1
Dragon_Tooth	Charizard,Dratini,Dragonair,Dragonite	610
Earth_Ball	Sandshrew,Sandslash,Diglett,Dugtrio,Geodude,Graveler,Golem,Onix,Cubone,Marowak,Rhyhorn,Rhydon,Wooper,Quagsire,Gligar,Steelix,Swinub,Piloswine,Phanpy,Donphan,Larvitar,Pupitar,Tyranitar	1
Electric_Box	Pikachu,Raichu,Magnemite,Magneton,Voltorb,Electrode,Electabuzz,Chinchou,Lanturn,Pichu,Mareep,Flaafy,Ampharos,Elekid	20
Enchanted_Gem	Abra,Kadabra,Alakazam,Slowpoke,Slowbro,Drowzee,Hypno,Exeggcute,Exeggutor,Starmie,Mr._Mime,Jynx,Natu,Xatu,Girafarig,Wobbuffet,Smoochum	1
Essence_of_Fire	Charmander,Charmeleon,Charizard,Vulpix,Ninetales,Growlithe,Arcanine,Ponyta,Rapidash,Magmar,Cyndaquil,Quilava,Typhlosion,Slugma,Magcargo,Houndour,Houndoom,Magby	1
Feather	Pidgey,Pidgeotto,Pidgeot,Spearow,Fearow,Farfetch'd,Doduo,Dodrio,Hoothoot,Noctowl,Natu,Xatu,Murkrow	40
Fur	Vulpix,Ninetales,Mankey,Primeape,Growlithe,Arcanine,Cyndaquil,Quilava,Typhlosion,Furret,Teddiursa,Ursaring,Swinub	13
Future_Orb	Abra,Kadabra,Alakazam,Drowzee,Hypno,Starmie,Mr._Mime,Jynx	400
Ghost_Essence	Gastly,Haunter,Gengar,Misdreavus	1
Horn	Rhyhorn,Rhydon,Kangaskhan,Goldeen,Seaking,Tauros	25
Ice_Orb	Seel,Dewgong,Shellder,Cloyster,Jynx,Sneasel,Delibird,Smoochum	33
Leaves	Bulbasaur,Ivysaur,Venusaur,Oddish,Gloom,Vileplume,Bellsprout,Weepinbell,Victreebel,Exeggcute,Exeggutor,Chikorita,Bayleef,Meganium,Sunkern,Sunflora	10
Nail	Meowth,Persian,Growlithe,Arcanine,Totodile,Croconaw,Feraligatr	10
Piece_of_Steel	Forretress,Steelix,Scizor,Skarmory,Magnemite,Magneton	1
Pot_of_Lava	Slugma,Magcargo,Houndour,Houndoom,Charmander,Charmeleon,Charizard,Vulpix,Ninetales,Growlithe,Arcanine,Ponyta,Rapidash,Magmar,Cyndaquil,Quilava,Typhlosion,Magby	18
Pot_of_Moss_Bug	Caterpie,Metapod,Butterfree,Weedle,Kakuna,Beedrill,Scyther,Pinsir,Yanma,Pineco,Forretress,Heracross	40
Rubber_Ball	Pidgey,Pidgeotto,Pidgeot,Rattata,Raticate,Spearow,Fearow,Clefairy,Clefable,Jigglypuff,Wigglytuff,Meowth,Persian,Farfetch'd,Doduo,Dodrio,Lickitung,Kangaskhan,Tauros,Snorlax,Sentret,Furret,Hoothoot,Noctowl,Cleffa,Igglybuff,Togepi,Togetic,Aipom,Girafarig,Dunsparce,Snubbull,Granbull,Teddiursa,Ursaring,Stantler,Miltank	1
Ruby	Persian,Golduck,Staryu,Starmie,Tentacool,Tentacruel	100
Sandbag	Wooper,Quagsire,Gligar,Phanpy,Donphan,Sandshrew,Sandslash,Nidoranfe,Nidorina,Nidoqueen,Nidoranma,Nidorino,Nidoking,Diglett,Dugtrio,Cubone,Marowak	15
Screw	Pikachu,Raichu,Magnemite,Magneton,Voltorb,Electrode,Electabuzz,Chinchou,Lanturn,Pichu,Mareep,Flaaffy,Ampharos,Elekid	1
Seed	Bulbasaur,Ivysaur,Venusaur,Oddish,Gloom,Vileplume,Paras,Parasect,Bellsprout,Weepinbell,Victreebel,Exeggcute,Exeggutor,Tangela,Chikorita,Bayleef,Meganium,Bellossom,Hoppip,Skiploom,Jumpluff,Sunkern,Sunflora	1
Small_Stone	Geodude,Graveler,Golem,Onix,Rhyhorn,Rhydon,Omanyte,Omastar,Kabuto,Kabutops,Aerodactyl,Sudowoodo,Schukle,Magcargo,Corsola,Larvitar,Pupitar,Tyranitar	1
Snowball	Dewgong,Cloyster,Jynx,Lapras,Sneasel,Swinub,Piloswine,Delibird,Smoochum	1
Stone_Orb	Geodude,Graveler,Golem,Onix,Kabuto,Kabutops,Aerodactyl,Sudowoodo,Larvitar,Pupitar,Tyranitar	400
Straw	Butterfree,Pidgey,Pidgeotto,Pidgeot,Spearow,Fearow,Zubat,Golbat,Farfetch'd,Doduo,Dodrio,Scyther,Gyarados,Aerodactyl,Dragonite,Hoothoot,Noctowl,Ledyba,Ledian,Crobat,Togetic,Xatu,Natu,Hoppip,Skiploom,Jumpluff,Yanma,Murkrow,Gligar,Delibird,Mantine,Skarmory	1
Tooth	Ekans,Arbok,Zubat,Golbat,Venonat	8
Water_Gem	Squirtle,Wartortle,Blastoise,Psyduck,Golduck,Poliwag,Poliwhirl,Poliwrath,Tentacool,Tentacruel,Slowpoke,Slowbro,Seel,Dewgong,Shellder,Cloyster,Krabby,Kingler,Horsea,Seadra,Goldeen,Seaking,Staryu,Starmie,Magikarp,Gyarados,Lapras,Omanyte,Omastar,Kabuto,Kabutops,Totodile,Croconaw,Feraligatr,Chinchou,Lanturn,Marill,Azumarill,Politoed,Wooper,Quagsire,Qwilfish,Corsola,Remoraid,Octillery,Mantine,Kingdra	1
Water_Pendant	Squirtle,Wartortle,Blastoise,Psyduck,Golduck,Poliwag,Poliwhirl,Poliwrath,Tentacool,Tentacruel,Slowpoke,Slowbro,Seel,Dewgong,Shellder,Cloyster,Horsea,Seadra,Goldeen,Seaking,Staryu,Starmie,Lapras,Omanyte,Omastar,Totodile,Croconaw,Feraligatr,Chinchou,Lanturn,Marill,Azumarill,Politoed,Wooper,Quagsire,Qwilfish,Remoraid,Octillery,Mantine,Kingdra	10
Armadillo_Claw	Sandshrew,Sandslash	147
Bat_Wing	Zubat,Golbat,Crobat	78
Bear_Paw	Ursaring	204
Bee_Sting	Weedle,Kakuna,Beedrill	54
Belt_of_Champion	Machop,Machoke,Machamp	1000
Blue_Ball	Marill,Azumarill	147
Blue_Vines	Tangela	123
Bone	Cubone,Marowak	123
Branch_Of_Stone	Sudowoodo	180
Brush	Smeargle	90
Bug_Antenna	Venonat	96
Bug_Venom	Venomoth	371
Bulb	Bulbasaur,Ivysaur,Venusaur	132
Bull_Tail	Tauros	102
Cat_Ear	Sneasel	123
Colored_Feather	Pidgey,Pidgeotto,Pidgeot	168
Cow_Tail	Miltank	180
Crab_Claw	Krabby,Kingler	90
Dark_Beak	Murkrow	123
Butterfly_Wing	Caterpie,Metapod,Butterfree	66
Dodrio_Feather	Doduo,Dodrio	102
Dog_Ears	Snubbull,Granbull	147
Dome_Fossil	Kabuto,Kabutops	8000
Dragon_Tail	Dratini,Dragonair,Dragonite	450
Egg_Shell	Togepi,Togetic	1000
Electric_Rat_Tail	Pichu,Pikachu,Raichu	132
Electric_Tail	Electabuzz,Elekid	1000
Elephant_Foot	Phanpy,Donphan	180
Farfetch'd_Stick	Farfetch'd	300
Female_Ear	Nidoran_Female,Nidorina,Nidoqueen	147
Fire_Ear	Slugma,Magcargo	135
Fire_Horse_Foot	Ponyta,Rapidash	114
Fire_Tail	Charmander,Charmeleon,Charizard	132
Fish_Fin	Goldeen,Seaking,Mantine	78
Fox_Tail	Ninetales,Vulpix	1000
Gem_Star	Staryu,Starmie	78
Giant_Bat_Wing	Crobat	180
Giant_Fin	Lapras	180
Giant_Piece_of_Fur	Growlithe,Arcanine	180
Giant_Ruby	Tentacool,Tentacruel	200
Gift_Bag	Delibird	90
Gligar_Claw	Gligar	90
Gosme	Grimer,Muk	78
Great_Petals	Chikorita,Bayleef,Meganium	132
Gyarados_Tail	Gyarados	800
Helicopter_Leaves	Hoppip	69
Helix_Fossil	Omanyte,Omastar	8000
Horn_Drill	Rhyhorn,Rhydon	168
Hot_Fur	Cyndaquil,Quilava,Typhlosion	132
Ice_Bra	Smoochum,Jynx	1000
Insect_Claw	Heracross	180
Insect_Tail	Yanma	114
Iron_Bracelet	Mankey,Primeape	114
Kanga_Ear	Kangaskhan	180
Karate_Duck	Golduck	123
Kick_Machine	Hitmonlee	135
Ladybug_Wing	Ledyba,Ledian	78
Linearly_Guided_Hypnose	Drowzee,Hypno	410
Lizard_Tail	Larvitar,Pupitar,Tyranitar	450
Locksmith_of_Shell	Shellder,Cloyster	24
Luck_Medallion	Meowth,Persian	1000
Magma_Foot	Magmar,Magby	1000
Magnet	Magnemite,Magneton	90
Male_Ear	Nidoran_Male,Nidorino,Nidoking	147
Microphone	Jigglypuff,Wigglytuff	147
Mimic_Clothes	Mr._Mime	450
Miss_Traces	Misdreavus	310
Monkey_Paw	Aipom	90
Mushroom	Parasect,Paras	114
Old_Amber	Aerodactyl	10000
Onix_Tail	Onix	371
Owl_Feather	Hoothoot,Noctowl	147
Piece_of_Coral	Corsola	114
Piece_of_Diglett	Diglett,Dugtrio	78
Piece_of_Shell	Pineco,Forretress	147
Pinsir_Horn	Pinsir	102
Plant_Foot	Exeggcute,Exeguttor	123
Plant_Tail	Bellsprout,Weepinbell,Victreebel	114
Point_of_Light	Chinchou,Lanturn	114
Psychic_Spoon	Kadabra,Alakazam	180
Psyduck_Mug	Psyduck,Golduck	129
Punch_Machine	Hitmonchan	135
Rat_Tail	Rattata,Raticate	54
Red_Scale	Totodile,Croconaw,Feraligatr	132
Red_Wing	Spearow,Fearow	114
Reindeer_Horn	Stantler	123
Scizor_Claw	Scizor	2000
Scythe	Scyther	1000
Seahorse_Tail	Horsea,Seadra,Kingdra	204
Seal_Tail	Seel,Dewgong	147
Sheep_Wool	Mareep,Flaaffy,Ampharos	132
Slow_Tail	Slowpoke,Slowbro	225
Small_Shell	Schukle	69
Small_Tail	Qwilfish	123
Small_Wings	Dunsparce	69
Snake_Tail	Ekans,Arbok	78
Spider_Legs	Spinarak,Ariados	78
Spin_Machine	Hitmontop	135
Squirrel_Tail	Sentret,Furret	78
Squirtle_Hull	Squirtle,Wartortle,Blastoise	132
Steel_Wings	Skarmory	192
Steelix_Tail	Steelix	2000
Sticky_Hand	Muk	120
Strange_Antenna	Girafarig	180
Strange_Bone	Houndour,Houndoom	180
Strange_Feather	Natu,Xatu	168
Strange_Flower	Oddish,Gloom,Vileplume	114
Strange_Rock	Geodude,Graveler,Golem	159
Strange_Spike	Cloyster	135
Strange_Tail	Wobbuffet	180
Strange_Thing	Poliwag,Poliwhirl,Poliwrath,Politoed	147
Streak_Tail	Mantine	180
Tentacle	Octillery	159
Tongue	Lickitung	410
Topknot	Cleffa,Clefairy,Clefable	147
Traces_Of_Ghost	Gastly,Haunter,Gengar,Misdreavus	180
Tusk	Swinub,Piloswine	180
Venom_Flute	Koffing,Weezing	78
Wool_ball	Meowth,Persian	69
Wooper_Horn	Wooper,Quagsire	147
Yellow_Flower	Bellossom,Hoppip,Skiploom,Jumpluff	114
